ACH = "countries/ACH.txt"
AFG = "countries/AFG.txt"
AHG = "countries/AHG.txt"
AIR = "countries/AIR.txt"
ALT = "countries/ALT.txt"
ANK = "countries/ANK.txt"
ARG = "countries/ARG.txt"
ASH = "countries/ASH.txt"
AST = "countries/AST.txt"
AUS = "countries/AUS.txt"
AWA = "countries/AWA.txt"
BAL = "countries/BAL.txt"
BEL = "countries/BEL.txt"
BER = "countries/BER.txt"
BGI = "countries/BGI.txt"
BHN = "countries/BHN.txt"
BHO = "countries/BHO.txt"
BHU = "countries/BHU.txt"
BIK = "countries/BIK.txt"
BLG = "countries/BLG.txt"
BNJ = "countries/BNJ.txt"
BNY = "countries/BNY.txt"
BOR = "countries/BOR.txt"
BRA = "countries/BRA.txt"
BRD = "countries/BRD.txt"
BRG = "countries/BRG.txt"
BRM = "countries/BRM.txt"
BST = "countries/BST.txt"
BTN = "countries/BTN.txt"
BUK = "countries/BUK.txt"
CAM = "countries/CAM.txt"
CAN = "countries/CAN.txt"
CHI = "countries/CHI.txt"
CHL = "countries/CHL.txt"
CHP = "countries/CHP.txt"
CLM = "countries/CLM.txt"
CMI = "countries/CMI.txt"
COG = "countries/COG.txt"
COL = "countries/COL.txt"
CRI = "countries/CRI.txt"
CUB = "countries/CUB.txt"
DAH = "countries/DAH.txt"
DEN = "countries/DEN.txt"
DFR = "countries/DFR.txt"
ECU = "countries/ECU.txt"
ELS = "countries/ELS.txt"
ENG = "countries/ENG.txt"
FIN = "countries/FIN.txt"
FRA = "countries/FRA.txt"
FRS = "countries/FRS.txt"
FTR = "countries/FTR.txt"
GER = "countries/GER.txt"
GRE = "countries/GRE.txt"
GUA = "countries/GUA.txt"
GZA = "countries/GZA.txt"
HAI = "countries/HAI.txt"
HAU = "countries/HAU.txt"
HAW = "countries/HAW.txt"
HDJ = "countries/HDJ.txt"
HND = "countries/HND.txt"
HOL = "countries/HOL.txt"
HON = "countries/HON.txt"
IBO = "countries/IBO.txt"
INS = "countries/INS.txt"
ION = "countries/ION.txt"
JAB = "countries/JAB.txt"
JAP = "countries/JAP.txt"
JMB = "countries/JMB.txt"
JOH = "countries/JOH.txt"
KAL = "countries/KAL.txt"
KAT = "countries/KAT.txt"
KHI = "countries/KHI.txt"
KOK = "countries/KOK.txt"
KOR = "countries/KOR.txt"
KRG = "countries/KRG.txt"
KTI = "countries/KTI.txt"
KUT = "countries/KUT.txt"
LAH = "countries/LAH.txt"
LAN = "countries/LAN.txt"
LBA = "countries/LBA.txt"
LIB = "countries/LIB.txt"
LUA = "countries/LUA.txt"
MAD = "countries/MAD.txt"
MAH = "countries/MAH.txt"
MAK = "countries/MAK.txt"
MAS = "countries/MAS.txt"
MEX = "countries/MEX.txt"
MGD = "countries/MGD.txt"
MJT = "countries/MJT.txt"
MKT = "countries/MKT.txt"
MOD = "countries/MOD.txt"
MOL = "countries/MOL.txt"
MOR = "countries/MOR.txt"
MSN = "countries/MSN.txt"
NAG = "countries/NAG.txt"
NEP = "countries/NEP.txt"
NOR = "countries/NOR.txt"
OMA = "countries/OMA.txt"
ORA = "countries/ORA.txt"
OYO = "countries/OYO.txt"
PAN = "countries/PAN.txt"
PAR = "countries/PAR.txt"
PBC = "countries/PBC.txt"
PER = "countries/PER.txt"
PHI = "countries/PHI.txt"
POR = "countries/POR.txt"
PRK = "countries/PRK.txt"
RAJ = "countries/RAJ.txt"
RSM = "countries/RSM.txt"
RWA = "countries/RWA.txt"
SAF = "countries/SAF.txt"
SAK = "countries/SAK.txt"
SAU = "countries/SAU.txt"
SEL = "countries/SEL.txt"
SER = "countries/SER.txt"
SGU = "countries/SGU.txt"
SHW = "countries/SHW.txt"
SIA = "countries/SIA.txt"
SID = "countries/SID.txt"
SIE = "countries/SIE.txt"
SIK = "countries/SIK.txt"
SIN = "countries/SIN.txt"
SLK = "countries/SLK.txt"
SMB = "countries/SMB.txt"
SOK = "countries/SOK.txt"
SOV = "countries/SOV.txt"
SPM = "countries/SPM.txt"
SPR = "countries/SPR.txt"
SRK = "countries/SRK.txt"
STG = "countries/STG.txt"
SUD = "countries/SUD.txt"
SUL = "countries/SUL.txt"
SWE = "countries/SWE.txt"
SWI = "countries/SWI.txt"
TAH = "countries/TAH.txt"
TBI = "countries/TBI.txt"
TIB = "countries/TIB.txt"
TIG = "countries/TIG.txt"
TRN = "countries/TRN.txt"
TTS = "countries/TTS.txt"
TUG = "countries/TUG.txt"
TUR = "countries/TUR.txt"
UAE = "countries/UAE.txt"
UCA = "countries/UCA.txt"
UGA = "countries/UGA.txt"
URG = "countries/URG.txt"
USA = "countries/USA.txt"
UZH = "countries/UZH.txt"
WAD = "countries/WAD.txt"
WAL = "countries/WAL.txt"
WES = "countries/WES.txt"
WSG = "countries/WSG.txt"
YUE = "countries/YUE.txt"
Z00 = "countries/Z00.txt"
Z01 = "countries/Z01.txt"
Z02 = "countries/Z02.txt"
Z03 = "countries/Z03.txt"
Z04 = "countries/Z04.txt"
Z05 = "countries/Z05.txt"
Z06 = "countries/Z06.txt"
Z07 = "countries/Z07.txt"
Z08 = "countries/Z08.txt"
Z09 = "countries/Z09.txt"
Z10 = "countries/Z10.txt"
Z11 = "countries/Z11.txt"
Z12 = "countries/Z12.txt"
Z13 = "countries/Z13.txt"
Z14 = "countries/Z14.txt"
Z15 = "countries/Z15.txt"
Z16 = "countries/Z16.txt"
Z17 = "countries/Z17.txt"
Z18 = "countries/Z18.txt"
ZAI = "countries/ZAI.txt"
ZAN = "countries/ZAN.txt"
ZUL = "countries/ZUL.txt"
TUN = "countries/TUN.txt"
ERI = "countries/ERI.txt"
CHA = "countries/CHA.txt"
SYR = "countries/SYR.txt"
WUU = "countries/WUU.txt"
SHU = "countries/SHU.txt"
WEI = "countries/WEI.txt"
HUN = "countries/HUN.txt"
AHU = "countries/AHU.txt"
OTT = "countries/OTT.txt"
CAL = "countries/CAL.txt"
CSA = "countries/CSA.txt"
MCL = "countries/MCL.txt"
NCR = "countries/NCR.txt"
GWR = "countries/GWR.txt"
GEI = "countries/GEI.txt"
POL = "countries/POL.txt"
EST = "countries/EST.txt"
UKR = "countries/UKR.txt"
BRS = "countries/BRS.txt"